levedekoning - Leve de koning!
willempie - Foto van onze sexy willem
lachen - Lachen joh
kek - kek
applaus - Applaus!
netjes - Netjes, netjes.
wat - wat
patat - Wat? Patat.
waardeloos - waerdeleus
perfect - perfect
jezus - Wat slecht
toppie - Toppie meid.
spanje - Een foto van Spanje
willemsliefde - De liefde voor willem
koningslied - Stuurt het koningslied
waarisdekoning - Stuurt de locatie van Willem
kopieerpasta - De fijnste WILLIEkeurige kopieerpasta's.
aanvalshelikopter - Trekkerwaarschuwing
meemsterkaas - de beste kaas
cirkeltrek - de beste onderlashet
goedepoep - dat is zeker goede poep daar
watzeije - wat zei je daar over mij?
stadhouders - even uitlaten
oorporno - De fijnste oorporno's van onder andere Dries.
drieswave - D R I E S W A V E
proost- Proost
opwillem - Opwillem
noice - noice.
spam - spam
feest - het is feest
gaben - een foto van onze heer
getrekkert - getrekkert
moetdit - moet dit
goedbezig - moet je nu een sticker?
nee - nee
ja - ja
doei - doei
ik_ihe - geeft de nieuwste ik_ihe post
papgrap - stuurt een papgrap
halt - halt
helemaalmooi - ik vind helemaal mooi
kut - kut
kutzooi - kutzooi
randig - randig
nederland - stuurt een foto van Nederland
angelsaksisch - hier spreekt men Nederlands
hoekig - hoekig
goedverhaal - jij krijgt een ballon
zucht - zucht.
kansloos - je leven
klapklap - ik lette op
veelspam - spam is lekker
zoutig - goede meem, slechte meem
meerjpeg - heeft meer nodig
opalberto - stuur een opalberto
levededevs - Wat info over de shitty developers
